1111111111111
10010000000C1
1000011111011
1P0011000E001
1111111111111