111111111111111111111111111111111111111111111111
1E0000000000000C00000C000000000001100C00000000C1
1000000000C0000C00000C00000C00000C00000C000000C1
11111111111111000000000C00CC011111110CCCC0000001
1P0000000C00C0000000000000000000C11010100C110001
1000000C000010011000000011000000C0000C100C0000C1
101001010010000010100100000001010000101010110111
101001010010000010100100000001010110111010000111
101001010010000010100100000001010000111010110111
101001010010000010100100000001010110101010000101
1010010100100000101001000000000000000000C1000C01
111111111111111111111111111111111111111111111111